NICHT BEARBEITEN !!! Infos zum Speichern der Daten in maps.py. Erstellen der Maps entweder direkt hier oder im Map-Editor. Daten: 
/006/
#000 LK #00000000000000000000000000000000000000000000000000000000000000000000000000000000000000000000000000000000000000000000000000000000000000000000000000000000000000000000000000000000000000000000000000000000000000000000000000000000000000000000000000000000000000000000000000000000000
#001 LK #11111111111111111111111111000000000000000000000001100000000000000000000000110000000000000000000000011000000000000000000000001100000000000000000000000110000000000000000000000011000000000000000000000001100000000000000000000000110000000000000000000000011111111111111111111111111
#002 LK #11111111111111111111111111300000000001000000000031101011101110101110111010100100010100010001010001001111101010111110101011111100010100000000000101000110101010102000001010101011010001010004000101000101101101101110101110110110113000000000010000000000311111111111111111111111111
#003 LK #11011111101101101111110110000000010004000100000000101010100013131000101010110101010111111111010101010010031010001000101300100100011100013131000111000110101000101111101000101011010101110000000111010101001010100020000000101010013001000100000001000100311101111110110110111111011
#004 LK #11111111111111111111111110000001000004000001000000111110101111011110101111110000010100000001010000011011111010110110101111101101000101031013010100010110101010101101101010101011000100010010100100010001101011101011011010111010113100000000000000000001311111111111200001111111111
#005 RM #11111111111111111111111111000000000000000000000001100000000000000000000000110000000000000000000000011000000000000000000000001100000000000000000000000110000000000000000000000011000000000000000000000001100000000000000000000000110000000000000000000000011111111111111111111111111
#006 RM #00000000000000000000000000000000000000000000000000000000000000000000000000000000000000000000000000000000000000000000000000000000000000000000000000000000000000000000000000000000000000000000000000000000000000000000000000000000000000000000000000000000000000000000000000000000000